pos_x=1.2;
pos_y=1.2;
angle=0;
width=10;
height=10;
map=
1,1,1,1,1,1,1,1,1,1
1,0,0,0,0,0,0,0,0,1
1,0,1,1,1,0,1,1,0,1
1,0,1,0,0,0,0,1,0,1
1,0,1,0,0,0,0,0,0,1
1,0,0,0,0,0,0,1,0,1
1,0,1,0,0,0,0,1,0,1
1,0,1,1,0,1,1,1,0,1
1,0,0,0,0,0,0,0,0,1
1,1,1,1,1,1,1,1,1,1